Métrique,Plomb_Valeur,LiKart_Valeur,Unité,Amélioration_Absolue,Amélioration_Relative_%
Disponibilité_Moyenne,75,95,%,20,26.7
Temps_Arrêt_Maintenance,12,0,heures/an,12,100.0
Autonomie_Hiver,60,90,%,30,50.0
Vitesse_Charge_Complète,9,2,heures,7,77.8
Poids_Transport,300,40,kg,260,86.7
Durée_Vie_Garantie,5,20,années,15,300.0
Cycles_Avant_Dégradation,500,8000,cycles,7500,1500.0
Coût_Maintenance_Annuel,1200,0,$,1200,100.0
Risque_Panne_Imprévue,25,2,%,23,92.0
Satisfaction_Utilisateur,6,9,/10,3,50.0